NO texter/wall_no.xpm
SO texter/wall_so.xpm
EA texter/wall_ea.Xpm
WE texter/wall_we.xpm

F 118,78,50
C 100,100,100




11111111111111111111111111111111111111111111111111111111111111111111111111111
1100000000000000000000000000001100000000N000000000000000000000000000000000001
11000000000000000001100000000000000000000000000000000000000000000000000000001
11000000000000000001100000000011000000000000000000000000000000000111110000001
11000000000000000001100001100000000000000011111000000000000000000000000000001
11000000000000000001100001100000000000000000000000000000000000011111111111111
1100000000000000000000000110000000001111110000000000000111111111
11000000000000000000000001100000000011000000000000000001
11000000000000000000000000000000000111110000000000000111
1100000000000000000000000000000000001100000000000000001
1111111111111111111111111111111111111111111111111111111