






        NO              ./texter/fi le1.xpm
        EA                      ./texter/fis le2.xpm    
SO              ./texter/fi le3.xpm
WE                                      ./texter/fi le4.xpm














F       220,100,1         
C       225,30,0             











        1111111111111111111111111
        1000000000110000000000001
        1011000001110000000000001
        1001000000000000000000001
111111111011000001110000000000001
100000000011000001110111111111111
11110111111111011100000010001
11110111111111011101010010001
11000000110101011100000010001
10000000000000001100000010001
100000N0000000001101010010001
11000001110101011111011110N0111
1111011111101011011110100011
111111111111111111111111111