








WE                                      ./texter/fi le4.xpm
                           NO                 ./texter/fi le1.xpm
        EA                      ./texter/fi le2.xpm  
                                SO              ./texter/fi le3.xpm









                C                                                225,130,0        
F       220,100,1         









        1111111111111111111111111 1
        1000000000110000000000001
        1011000001110000000000001
        1001000000000000000000001
111111111011000001110000000000001
100N00000011000001110111111111111
11110111111111111100000010001
11110111111111011101010010001                  11111
11000000110101011100000010001                  11001
100000000000000001000000010001                  11111
1000000000000000000101010010001
1100000111010101111101111000111
11110111 10001000101111010001
11111  1 110000111011111111111
11111  1 1000111 101111111111 
11111111 1111111 111111111111



1111111111111111
1111111111111111
1111111111111111

