








WE                                      ./texter/file3.xpm
                           NO                 ./texter/fi le1.xpm
        EA                      ./texter/fi le2.xpm  
                                SO              ./texter/fi le3.xpm









                C                                                225,130,0        
F       220,100,1         









        1111111111111111111111111 
        1000000000110000000000001
        1011000001110000000000001
        1001000000000000000000001
111111111011000001110000000000001
10000000011000001110111111111111
111N0111111111111100000010001
11110111111111011101010010001                 
11000000110101011100000010001                 
10000000000000000100000001001                  
10000000000000000001010100101
11000001110101011111011110001
11110111 10001000101111010001
11111  1 11000011101111110111
11111  1 1000111 100000000111 
11111111 1111111 111111111111

